2
0
0 0
10 10
b 0 0 0 1 2 0 0 0 c
0 0 0 0 2 1 0 0 0 0
0 0 0 0 0 0 0 0 0 0
0 0 0 - - - - 0 0 0
2 1 0 - - - - 0 2 1
1 2 0 - - - - 0 1 2
0 0 0 - - - - 0 0 0
0 0 0 0 0 0 0 0 0 0
0 0 0 0 1 2 0 0 0 0
c 0 0 0 2 1 0 0 0 b
0 0 7 <-> 9 9 3
0 9 5 <-> 9 0 1
