3
4
1 3
15 15
- - - - - 0 0 0 0 0 - - - - 0
- - - 0 0 0 0 c 0 0 - - - - -
- - 0 0 0 0 0 0 0 0 - x i - -
- 0 0 0 0 0 x x x 0 - c b - -
- 0 0 0 0 0 0 0 0 0 - - - - -
0 0 0 0 0 0 0 0 0 0 0 0 0 0 0
0 0 0 0 0 0 3 2 1 0 0 x 0 0 0
0 i 0 0 0 0 2 1 3 0 0 x 0 c 0
0 0 0 0 0 0 1 3 2 0 0 x 0 0 0
0 0 0 0 0 0 0 0 0 0 0 0 0 0 0
- 0 0 0 0 0 0 0 0 0 0 0 0 0 -
- 0 0 0 0 0 0 0 0 0 0 0 0 0 -
- - 0 0 0 0 b 0 b 0 0 0 0 - -
- - - 0 0 0 0 0 0 0 0 0 - - -
- - - - - 0 0 0 0 0 - - - - -
0 5 0 <-> 5 0 6
9 0 2 <-> 14 5 0
14 9 4 <-> 9 14 2
5 14 6 <-> 0 9 4
2 12 4 <-> 14 0 0
2 12 6 <-> 14 0 5

