3
2
1 1
20 20
- - - - - c 0 0 - - - 0 0 c - - - - - -
- - - - - 0 0 0 - - - 0 0 0 - - - - - -
- - - - - 0 0 0 - - - 0 0 0 - - - - - -
- - - - - 0 0 0 - - - 0 0 0 - - - - - -
- - - - 0 0 3 1 0 - 0 0 0 0 0 - - - - -
- - - 0 0 0 1 3 0 - 0 0 0 0 0 0 - - - -
- - 0 0 0 0 0 0 0 - 0 0 0 0 0 0 0 - - -
- 0 0 0 0 0 0 0 0 - 0 0 0 0 0 0 0 0 - -
b 0 0 0 0 0 0 0 0 0 0 0 0 0 0 0 0 0 x -
0 0 0 0 0 0 0 0 2 3 1 0 0 0 0 0 0 0 0 -
0 0 0 0 0 0 0 0 1 2 3 0 0 0 0 0 0 0 0 -
x 0 0 0 0 0 0 0 3 1 2 0 0 0 0 0 0 0 b -
- 0 0 0 0 0 0 0 0 0 0 0 0 0 0 0 0 0 - -
- - 0 0 0 0 0 0 0 - 0 0 0 0 0 0 0 - - -
- - - 0 0 0 3 2 0 - 0 2 1 0 0 0 - - - -
- - - - 0 0 2 3 0 - 0 1 2 0 0 - - - - -
- - - - - 0 0 0 - - - 0 0 0 - - - - - -
- - - - - 0 0 0 - - - 0 0 0 - - - - - -
- - - - - 0 0 0 - - - 0 0 0 - - - - - -
- - - - - i 0 0 - - - 0 0 i - - - - - -
1 7 6 <-> 17 7 2
2 6 6 <-> 16 6 2
3 5 6 <-> 15 5 2
4 4 6 <-> 14 4 2
1 12 6 <-> 17 12 2
2 13 6 <-> 16 13 2
3 14 6 <-> 15 14 2
4 15 6 <-> 14 15 2
