4
5
1 2
16 20
0 0 0 0 - - 0 0 0 0 0 0 0 0 - - 0 0 0 0
0 b 0 0 - - 0 0 0 x x 0 0 0 - 0 0 0 i 0
0 0 0 0 - - 0 0 0 x x 0 0 0 0 - 0 0 0 0
0 0 0 0 - - 0 0 0 0 0 0 0 0 - - 0 0 0 0
0 0 0 0 - - 0 0 0 0 0 0 0 0 - - 0 - - 0
0 0 0 0 i 0 0 0 0 0 0 0 0 0 - - 0 0 0 0
- - - - - - 0 0 4 3 1 2 0 0 - - 0 0 0 0
- - - - - - 0 0 3 4 2 1 0 0 0 0 0 0 0 0
- - - - - - 0 0 2 1 3 4 0 0 0 0 0 0 0 0
- - - - - - 0 0 1 2 4 3 0 0 - - 0 0 0 0
0 0 0 0 c 0 0 0 0 0 0 0 0 0 - - 0 0 0 0
0 0 0 0 - - 0 0 0 0 0 0 0 0 - - 0 - - 0
0 0 0 0 - - 0 0 0 0 0 0 0 0 - - 0 0 0 0
0 0 0 0 - - 0 0 0 x x 0 0 0 0 - 0 0 0 0
0 0 0 0 - - 0 0 0 x x 0 0 0 - 0 0 0 b 0
0 0 0 0 - - 0 0 0 0 0 0 0 0 - - 0 0 0 0
