2
5
6 2
10 40
1 2 0 0 0 0 b - - - - - b 0 0 0 0 0 0 0 b - - - - - b 0 0 0 0 0 0 0 b - - - - -
0 0 0 0 0 0 0 - - - - - 0 0 0 0 0 0 0 0 0 - - - - - 0 0 0 0 0 0 0 0 0 - - - - -
0 0 0 0 0 0 0 - - - - - 0 0 0 0 0 0 0 0 0 - - - - - 0 0 0 0 0 0 0 0 0 - - - - -
0 0 0 0 0 0 0 - - - - - 0 0 0 0 0 0 0 0 0 - - - - - 0 0 0 0 0 0 0 0 0 - - - - -
b 0 0 0 0 0 i - - - - - i 0 0 0 0 0 0 c 0 - - - - - i 0 0 0 0 0 0 0 i - - - - -
- - - - - i 0 0 0 0 0 0 0 i - - - - - 0 c 0 0 0 0 0 0 i - - - - - i 0 0 0 0 0 b
- - - - - 0 0 0 0 0 0 0 0 0 - - - - - 0 0 0 0 0 0 0 0 0 - - - - - 0 0 0 0 0 0 0
- - - - - 0 0 0 0 0 0 0 0 0 - - - - - 0 0 0 0 0 0 0 0 0 - - - - - 0 0 0 0 0 0 0
- - - - - 0 0 0 0 0 0 0 0 0 - - - - - 0 0 0 0 0 0 0 0 0 - - - - - 0 0 0 0 0 0 0
- - - - - b 0 0 0 0 0 0 0 b - - - - - b 0 0 0 0 0 0 0 b - - - - - b 0 0 0 0 1 2
0 2 6 <-> 39 7 2
