8
4
1 4
20 20
- - - - - - 8 4 0 0 0 0 3 7 - - - - - -
- - - - - 0 4 8 0 0 0 0 7 3 0 - - - - -
- - - - 0 0 0 0 0 0 0 0 0 0 0 0 - - - -
- - - 0 0 i 0 0 0 0 0 0 0 0 0 0 0 - - -
- - 0 0 0 0 0 0 0 0 x 0 0 0 0 0 0 0 - -
- 0 0 0 0 0 0 0 0 x 0 0 0 0 0 0 0 0 0 -
1 5 0 0 0 x 0 0 0 0 0 0 0 0 x 0 0 0 2 6
5 1 0 0 0 - 0 0 0 0 0 0 0 0 - 0 0 0 6 2
0 0 0 0 - - - 0 0 0 0 0 0 - - - 0 0 0 0
0 0 0 - - - - - 0 c b 0 - - - - - 0 0 0
0 0 0 - - - - - 0 b c 0 - - - - - 0 0 0
0 0 0 0 - - - 0 0 0 0 0 0 - - - 0 0 0 0
6 2 0 0 0 - 0 0 0 0 0 0 0 0 - 0 0 0 5 1
2 6 0 0 0 x 0 0 0 0 0 0 0 0 x 0 0 0 1 5
- 0 0 0 0 0 0 0 0 x 0 0 0 0 0 0 0 0 0 -
- - 0 0 0 0 0 0 0 0 x 0 0 0 0 0 0 0 - -
- - - 0 0 0 0 0 0 0 0 0 0 0 0 0 0 - - -
- - - - 0 0 0 0 0 0 0 0 0 0 0 0 - - - -
- - - - - 0 7 3 0 0 0 0 4 8 0 - - - - -
- - - - - - 3 7 0 0 0 0 8 4 - - - - - -
1 5 7 <-> 18 14 3
2 4 7 <-> 17 15 3
3 3 7 <-> 16 16 3
4 2 7 <-> 15 17 3
5 1 7 <-> 14 18 3
1 14 5 <-> 14 1 1
2 15 5 <-> 15 2 1
3 16 5 <-> 16 3 1
4 17 5 <-> 17 4 1
5 18 5 <-> 18 5 1
