4
2
1 1
24 24
- - - - - - - - - - - - - - - - - - - - - - - -
- - 0 0 0 - - - - 0 0 0 0 0 0 - - - - 0 0 0 - -
- 0 0 3 0 0 - - - 0 0 0 0 0 0 - - - 0 0 2 0 0 -
- 0 2 x 4 0 - - - 0 0 c c 0 0 - - - 0 1 x 3 0 -
- 0 0 1 0 0 - - - 0 0 c c 0 0 - - - 0 0 4 0 0 -
- - 0 0 0 - - - - 0 0 0 0 0 0 - - - - 0 0 0 - -
- - - - - - - - - 0 0 0 0 0 0 - - - - - - - - -
- - - - - - - - - 0 0 0 0 0 0 - - - - - - - - -
- - - - - - - - - 0 0 0 0 0 0 - - - - - - - - -
- b 0 0 0 0 0 0 0 0 0 0 0 0 0 0 0 0 0 0 0 0 b -
- 0 0 0 0 0 0 0 0 0 1 2 3 4 0 0 0 0 0 0 0 0 0 -
- 0 0 i i 0 0 0 0 0 4 1 2 3 0 0 0 0 0 i i 0 0 -
- 0 0 i i 0 0 0 0 0 3 4 1 2 0 0 0 0 0 i i 0 0 -
- 0 0 0 0 0 0 0 0 0 2 3 4 1 0 0 0 0 0 0 0 0 0 -
- b 0 0 0 0 0 0 0 0 0 0 0 0 0 0 0 0 0 0 0 0 b -
- - - - - - - - - 0 0 0 0 0 0 - - - - - - - - -
- - - - - - - - - 0 0 0 0 0 0 - - - - - - - - -
- - - - - - - - - 0 0 0 0 0 0 - - - - - - - - -
- - 0 0 0 - - - - 0 0 0 0 0 0 - - - - 0 0 0 - -
- 0 0 4 0 0 - - - 0 0 c c 0 0 - - - 0 0 1 0 0 -
- 0 3 x 1 0 - - - 0 0 c c 0 0 - - - 0 4 x 2 0 -
- 0 0 2 0 0 - - - 0 0 0 0 0 0 - - - 0 0 3 0 0 -
- - 0 0 0 - - - - 0 0 0 0 0 0 - - - - 0 0 0 - -
- - - - - - - - - - - - - - - - - - - - - - - -
1 2 6 <-> 9 1 0
1 3 6 <-> 10 1 0
1 4 6 <-> 11 1 0
22 2 2 <-> 12 1 0
22 3 2 <-> 13 1 0
22 4 2 <-> 14 1 0
5 2 2 <-> 18 2 6
5 3 2 <-> 18 3 6
5 4 2 <-> 18 4 6
1 19 6 <-> 9 22 4
1 20 6 <-> 10 22 4
1 21 6 <-> 11 22 4
22 19 2 <-> 12 22 4
22 20 2 <-> 13 22 4
22 21 2 <-> 14 22 4
5 19 2 <-> 18 19 6
5 20 2 <-> 18 20 6
5 21 2 <-> 18 21 6
2 1 0 <-> 2 22 4
3 1 0 <-> 3 22 4
4 1 0 <-> 4 22 4
2 5 4 <-> 2 18 0
3 5 4 <-> 3 18 0
4 5 4 <-> 4 18 0
19 1 0 <-> 19 22 4
20 1 0 <-> 20 22 4
21 1 0 <-> 21 22 4
19 5 4 <-> 19 18 0
20 5 4 <-> 20 18 0
21 5 4 <-> 21 18 0

