4

5
6 2
20 20
0 0 0 0 0 0 0 0 0 0 0 0 0 0 0 0 0 0 0 0
0 0 0 0 0 0 0 0 0 2 1 0 0 0 0 0 0 0 0 0
0 0 i 0 0 0 0 0 0 4 3 0 0 0 0 0 0 i 0 0
0 0 0 - - b 0 0 0 0 0 0 0 0 b - - 0 0 0
0 0 0 - - 0 0 0 0 0 0 0 0 0 0 - - 0 0 0
0 0 b 0 0 - - - - - - - - - - 0 0 b 0 0
0 0 0 0 0 - - - - - - - - - - 0 0 0 0 0
0 x 0 0 0 - - - - - - - - - - 0 0 0 x 0
0 0 0 0 0 - - - 0 0 0 0 - - - 0 0 0 0 0
0 0 0 b 0 - - - 0 c 0 0 - - - 0 0 0 0 0
0 0 0 0 0 - - - 0 0 c 0 - - - 0 b 0 0 0
0 0 0 0 0 - - - 0 0 0 0 - - - 0 0 0 0 0
0 x 0 0 0 - - - - - - - - - - 0 0 0 x 0
0 0 0 0 0 - - - - - - - - - - 0 0 0 0 0
0 0 b 0 0 - - - - - - - - - - 0 0 b 0 0
0 0 0 - - 0 0 0 0 0 0 0 0 0 0 - - 0 0 0
0 0 0 - - b 0 0 0 0 0 0 0 0 b - - 0 0 0
0 0 i 0 0 0 0 0 0 1 2 0 0 0 0 0 0 i 0 0
0 0 0 0 0 0 0 0 0 3 4 0 0 0 0 0 0 0 0 0
0 0 0 0 0 0 0 0 0 0 0 0 0 0 0 0 0 0 0 0
4 14 2 <-> 8 10 5
15 5 6 <-> 11 8 1
