6
12
3 2
20 20
- - - - - 0 0 0 0 0 0 0 0 0 0 - - - - -
- - - - - 0 0 0 0 0 0 0 0 0 0 - - - - -
- - - - - 0 0 0 0 0 0 0 0 0 0 - - - - -
- - - - - 0 0 0 0 0 0 0 0 0 0 - - - - -
- - - - - 0 0 0 0 0 0 0 0 0 0 - - - - -
0 0 0 0 0 0 0 0 0 0 0 0 0 0 0 0 0 0 0 0
0 0 0 0 0 0 1 2 0 0 0 0 b 0 0 0 0 0 0 0
0 0 0 0 0 0 2 1 0 0 0 0 0 0 0 0 0 0 0 0
0 0 b 0 0 0 0 0 0 0 0 0 0 0 0 0 0 0 0 0
0 0 0 0 0 0 0 0 0 0 0 0 0 0 0 0 0 0 0 0
0 0 0 0 0 0 4 3 0 0 0 0 0 0 0 0 0 0 0 0
0 0 0 0 0 0 3 4 0 0 5 6 0 0 0 0 0 0 0 0
0 0 c 0 0 0 0 0 0 0 6 5 0 0 c 0 0 0 c 0
0 0 0 0 0 0 0 0 0 0 0 0 0 0 0 0 0 0 0 0
0 0 0 0 0 0 0 0 0 0 0 0 0 0 0 0 0 0 0 0
- - - - - 0 0 0 0 0 0 0 x 0 0 - - - - -
- - - - - 0 0 0 b 0 0 0 x 0 0 - - - - -
- - - - - 0 0 0 0 0 0 0 x 0 0 - - - - -
- - - - - 0 0 0 0 0 0 0 b 0 0 - - - - -
- - - - - 0 0 0 0 0 0 0 0 0 0 - - - - -
5 0 7 <-> 14 19 3
14 0 1 <-> 5 19 5
