8
0
0 2
23 23
1 2 0 0 0 0 0 - - - - - - - - - 0 0 0 0 0 1 2
4 3 0 0 0 0 0 - - - - - - - - - 0 0 0 0 0 4 3
0 0 0 0 0 0 0 0 0 0 0 0 0 0 0 0 0 0 0 0 0 0 0
0 0 0 0 0 0 0 0 0 0 0 0 0 0 0 0 0 0 0 0 0 0 0
0 0 0 0 0 0 0 - - - 0 0 0 - - - 0 0 0 0 0 0 0
0 0 0 0 0 5 6 - - - 0 0 0 - - - 5 6 0 0 0 0 0
0 0 0 0 0 8 7 - - - 0 0 0 - - - 8 7 0 0 0 0 0
- - 0 0 - - - - - - - 0 - - - - - - - 0 0 - -
- - 0 0 - - - - 0 b b 0 b b 0 - - - - 0 0 - -
- - 0 0 - - - - b 0 b 0 b 0 b - - - - 0 0 - -
- - 0 0 0 0 0 - b b b 0 b b b - 0 0 0 0 0 - -
- - 0 0 0 0 0 0 0 0 0 0 0 0 0 0 0 0 0 0 0 - -
- - 0 0 0 0 0 - b b b 0 b b b - 0 0 0 0 0 - -
- - 0 0 - - - - b 0 b 0 b 0 b - - - - 0 0 - -
- - 0 0 - - - - 0 b b 0 b b 0 - - - - 0 0 - -
- - 0 0 - - - - - - - 0 - - - - - - - 0 0 - -
0 0 0 0 0 5 6 - - - 0 0 0 - - - 5 6 0 0 0 0 0
0 0 0 0 0 8 7 - - - 0 0 0 - - - 8 7 0 0 0 0 0
0 0 0 0 0 0 0 - - - 0 0 0 - - - 0 0 0 0 0 0 0
0 0 0 0 0 0 0 0 0 0 0 0 0 0 0 0 0 0 0 0 0 0 0
0 0 0 0 0 0 0 0 0 0 0 0 0 0 0 0 0 0 0 0 0 0 0
1 2 0 0 0 0 0 - - - - - - - - - 0 0 0 0 0 1 2
4 3 0 0 0 0 0 - - - - - - - - - 0 0 0 0 0 4 3
