8
2
2 2
30 30
- - - - - - - - - - - - - - - - - - - - - - - - - - - - - -
- 0 0 0 0 0 0 0 0 0 0 0 0 0 0 0 0 0 0 0 0 0 0 0 0 0 0 0 0 -
- 0 b 0 0 0 0 0 0 0 0 0 0 0 0 0 0 0 0 0 0 0 0 0 0 0 0 b 0 -
- 0 0 0 0 0 0 0 0 0 0 0 0 0 0 0 0 0 0 0 0 0 0 0 0 0 0 0 0 -
- 0 0 0 - - - - - - - - - - c c - - - - - - - - - - 0 0 0 -
- 0 0 0 - 0 0 0 0 0 0 0 0 0 0 0 0 0 0 0 0 0 0 0 0 - 0 0 0 -
- 0 0 0 - 0 b 0 0 0 0 0 0 0 0 0 0 0 0 0 0 0 0 b 0 - 0 0 0 -
- 0 0 0 - 0 0 0 0 0 0 0 0 0 0 0 0 0 0 0 0 0 0 0 0 - 0 0 0 -
- 0 0 0 - 0 0 0 - - - - - - 0 0 - - - - - - 0 0 0 - 0 0 0 -
- 0 0 0 - 0 0 0 - - - - - - 0 0 - - - - - - 0 0 0 - 0 0 0 -
- 0 0 0 - 0 0 0 - - - - - - 0 0 - - - - - - 0 0 0 - 0 0 0 -
- 0 0 0 - 0 0 0 - - - - - - 0 0 - - - - - - 0 0 0 - 0 0 0 -
- 0 0 0 - 0 0 0 - - - - - - x x - - - - - - 0 0 0 - 0 0 0 -
- 0 0 0 - 0 0 0 - - - - - - 1 2 - - - - - - 0 0 0 - 0 0 0 -
- 0 0 0 i 0 0 0 0 0 0 0 x 8 0 0 3 x 0 0 0 0 0 0 0 i 0 0 0 -
- 0 0 0 i 0 0 0 0 0 0 0 x 7 0 0 4 x 0 0 0 0 0 0 0 i 0 0 0 -
- 0 0 0 - 0 0 0 - - - - - - 6 5 - - - - - - 0 0 0 - 0 0 0 -
- 0 0 0 - 0 0 0 - - - - - - x x - - - - - - 0 0 0 - 0 0 0 -
- 0 0 0 - 0 0 0 - - - - - - 0 0 - - - - - - 0 0 0 - 0 0 0 -
- 0 0 0 - 0 0 0 - - - - - - 0 0 - - - - - - 0 0 0 - 0 0 0 -
- 0 0 0 - 0 0 0 - - - - - - 0 0 - - - - - - 0 0 0 - 0 0 0 -
- 0 0 0 - 0 0 0 - - - - - - 0 0 - - - - - - 0 0 0 - 0 0 0 -
- 0 0 0 - 0 0 0 0 0 0 0 0 0 0 0 0 0 0 0 0 0 0 0 0 - 0 0 0 -
- 0 0 0 - 0 b 0 0 0 0 0 0 0 0 0 0 0 0 0 0 0 0 b 0 - 0 0 0 -
- 0 0 0 - 0 0 0 0 0 0 0 0 0 0 0 0 0 0 0 0 0 0 0 0 - 0 0 0 -
- 0 0 0 - - - - - - - - - - c c - - - - - - - - - - 0 0 0 -
- 0 0 0 0 0 0 0 0 0 0 0 0 0 0 0 0 0 0 0 0 0 0 0 0 0 0 0 0 -
- 0 b 0 0 0 0 0 0 0 0 0 0 0 0 0 0 0 0 0 0 0 0 0 0 0 0 b 0 -
- 0 0 0 0 0 0 0 0 0 0 0 0 0 0 0 0 0 0 0 0 0 0 0 0 0 0 0 0 -
- - - - - - - - - - - - - - - - - - - - - - - - - - - - - -
