8
5
2 3
30 30
0 c 0 0 0 0 0 0 0 b 0 0 0 0 0 0 0 0 0 b 0 0 0 0 0 0 0 0 c 0
c 0 0 0 0 0 0 0 0 0 0 0 0 0 0 0 0 0 0 0 0 0 0 0 0 0 0 0 0 c
0 0 0 0 0 0 0 0 0 0 0 0 0 0 0 0 0 0 0 0 0 0 0 0 0 0 0 0 0 0
0 0 0 0 0 0 0 0 0 0 0 0 0 0 0 0 0 0 0 0 0 0 0 0 0 0 0 0 0 0
0 0 0 - - - - - 0 0 - 0 0 0 0 0 0 0 0 - 0 0 - - - - - 0 0 0
0 0 0 - 0 0 0 0 0 0 - 0 0 0 0 0 0 0 0 - 0 0 - 0 0 0 - 0 0 0 
0 0 0 - 0 0 0 0 0 0 - 0 0 0 0 0 0 0 0 - 0 0 - 0 0 0 - 0 0 0
0 0 0 - 0 0 0 0 0 0 - 0 0 0 0 0 0 0 0 - 0 0 - 0 0 0 - 0 0 0
0 0 0 - - - - - 0 0 - 0 0 - - - - 0 0 - 0 0 - - - - - 0 0 0
b 0 0 0 0 0 0 - 0 0 - 0 0 - 0 0 - 0 0 - 0 0 - 0 0 0 0 0 0 b
0 0 0 0 0 0 0 - 0 0 - 0 0 - 0 0 - 0 0 - 0 0 - 0 0 0 0 0 0 0
0 0 0 0 0 0 0 - 0 0 - 0 0 - 0 0 - 0 0 - 0 0 - 0 0 0 0 0 0 0
0 0 0 - - - - - 0 0 - - - - 0 0 - - - - 0 0 - 0 0 0 0 0 0 0
0 0 0 0 0 0 0 0 0 0 0 0 0 0 0 0 0 0 0 0 0 0 0 0 0 0 0 0 0 0 
0 0 0 0 0 0 0 0 0 0 0 0 0 0 0 0 0 0 0 0 0 0 0 0 0 0 0 0 0 0
0 0 1 2 3 4 0 0 0 0 0 0 0 0 0 0 0 0 0 0 0 0 0 0 0 0 0 0 0 0
0 0 2 3 4 1 0 0 0 0 0 0 0 0 0 0 0 0 0 0 0 0 0 0 i 0 0 0 0 0
0 0 3 4 1 2 0 0 x 0 0 0 x x x x 0 0 0 0 0 0 0 0 0 0 0 0 0 0
0 0 4 1 2 3 0 0 0 0 0 0 0 0 0 x 0 0 0 0 0 0 0 0 0 0 0 0 0 0
b 0 0 0 0 0 0 0 x 0 0 0 0 0 0 x 0 0 0 0 0 0 0 0 0 0 0 0 0 b
0 0 0 0 0 0 0 0 x 0 0 0 x x x x 0 0 0 0 0 0 0 0 0 0 0 0 0 0
0 0 0 0 0 0 0 0 x 0 0 0 x 0 0 0 0 0 0 0 0 0 0 0 0 0 0 0 0 0
0 0 0 0 0 0 0 0 x 0 0 0 x 0 0 0 0 0 0 0 0 0 0 0 0 0 0 0 0 0
0 0 5 6 7 8 0 0 x 0 0 0 x x x x 0 0 0 0 0 0 0 0 0 0 0 0 0 0
0 0 6 7 8 5 0 0 0 0 0 0 0 0 0 0 0 0 0 0 0 0 0 0 0 0 0 0 0 0
0 0 7 8 5 6 0 0 0 0 0 0 0 0 0 0 0 0 0 0 0 0 0 0 0 0 0 0 0 0
0 0 8 5 6 7 0 0 0 0 0 0 0 0 0 0 0 0 0 0 0 0 0 0 0 0 0 0 0 0
0 0 0 0 0 0 0 0 0 0 0 0 0 0 0 0 0 0 0 0 0 0 0 i 0 0 0 0 0 0
c 0 0 0 0 0 0 0 0 0 0 0 0 0 0 0 0 0 0 0 0 0 0 0 0 0 0 0 0 c
0 c 0 0 0 0 0 0 0 b 0 0 0 0 0 0 0 0 0 b 0 0 0 0 0 0 0 0 c 0 
0 0 7 <-> 23 5 7
0 29 5 <-> 23 7 5
29 0 1 <-> 25 5 1
29 29 3 <-> 25 7 3
