2
0
5 2
50 50
0 0 0 0 0 - - - - - 0 0 0 0 0 - - - - - 0 0 0 0 0 - - - - - 0 0 0 0 0 - - - - - 0 0 0 0 0 - - - - -
0 1 2 0 0 - - - - - 0 0 0 0 0 - - - - - 0 0 0 0 0 - - - - - 0 0 0 0 0 - - - - - 0 0 0 0 0 - - - - -
0 2 1 0 0 - - - - - 0 0 0 0 0 - - - - - 0 0 0 0 0 - - - - - 0 0 0 0 0 - - - - - 0 0 0 0 0 - - - - -
0 0 0 0 0 - - - - - 0 0 0 0 0 - - - - - 0 0 0 0 0 - - - - - 0 0 0 0 0 - - - - - 0 0 0 0 0 - - - - -
0 0 0 0 0 - - - - - 0 0 0 0 0 - - - - - 0 0 0 0 0 - - - - - 0 0 0 0 0 - - - - - 0 0 0 0 0 - - - - -
- - - - - 0 0 0 0 0 - - - - - 0 0 0 0 0 - - - - - 0 0 0 0 0 - - - - - 0 0 0 0 0 - - - - - 0 0 0 0 0
- - - - - 0 0 0 0 0 - - - - - 0 0 0 0 0 - - - - - 0 0 0 0 0 - - - - - 0 0 0 0 0 - - - - - 0 0 0 0 0
- - - - - 0 0 0 0 0 - - - - - 0 0 0 0 0 - - - - - 0 0 0 0 0 - - - - - 0 0 0 0 0 - - - - - 0 0 0 0 0
- - - - - 0 0 0 0 0 - - - - - 0 0 0 0 0 - - - - - 0 0 0 0 0 - - - - - 0 0 0 0 0 - - - - - 0 0 0 0 0
- - - - - 0 0 0 0 0 - - - - - 0 0 0 0 0 - - - - - 0 0 0 0 0 - - - - - 0 0 0 0 0 - - - - - 0 0 0 0 0
0 0 0 0 0 - - - - - 0 0 0 0 0 - - - - - 0 0 0 0 0 - - - - - 0 0 0 0 0 - - - - - 0 0 0 0 0 - - - - -
0 0 0 0 0 - - - - - 0 0 0 0 0 - - - - - 0 0 0 0 0 - - - - - 0 0 0 0 0 - - - - - 0 0 0 0 0 - - - - -
0 0 0 0 0 - - - - - 0 0 0 0 0 - - - - - 0 0 0 0 0 - - - - - 0 0 0 0 0 - - - - - 0 0 0 0 0 - - - - -
0 0 0 0 0 - - - - - 0 0 0 0 0 - - - - - 0 0 0 0 0 - - - - - 0 0 0 0 0 - - - - - 0 0 0 0 0 - - - - -
0 0 0 0 0 - - - - - 0 0 0 0 0 - - - - - 0 0 0 0 0 - - - - - 0 0 0 0 0 - - - - - 0 0 0 0 0 - - - - -
- - - - - 0 0 0 0 0 - - - - - 0 0 0 0 0 - - - - - 0 0 0 0 0 - - - - - 0 0 0 0 0 - - - - - 0 0 0 0 0
- - - - - 0 0 0 0 0 - - - - - 0 0 0 0 0 - - - - - 0 0 0 0 0 - - - - - 0 0 0 0 0 - - - - - 0 0 0 0 0
- - - - - 0 0 0 0 0 - - - - - 0 0 0 0 0 - - - - - 0 0 0 0 0 - - - - - 0 0 0 0 0 - - - - - 0 0 0 0 0
- - - - - 0 0 0 0 0 - - - - - 0 0 0 0 0 - - - - - 0 0 0 0 0 - - - - - 0 0 0 0 0 - - - - - 0 0 0 0 0
- - - - - 0 0 0 0 0 - - - - - 0 0 0 0 0 - - - - - 0 0 0 0 0 - - - - - 0 0 0 0 0 - - - - - 0 0 0 0 0
0 0 0 0 0 - - - - - 0 0 0 0 0 - - - - - 0 0 0 0 0 - - - - - 0 0 0 0 0 - - - - - 0 0 0 0 0 - - - - -
0 0 0 0 0 - - - - - 0 0 0 0 0 - - - - - 0 0 0 0 0 - - - - - 0 0 0 0 0 - - - - - 0 0 0 0 0 - - - - -
0 0 0 0 0 - - - - - 0 0 0 0 0 - - - - - 0 0 0 0 0 - - - - - 0 0 0 0 0 - - - - - 0 0 0 0 0 - - - - -
0 0 0 0 0 - - - - - 0 0 0 0 0 - - - - - 0 0 0 0 0 - - - - - 0 0 0 0 0 - - - - - 0 0 0 0 0 - - - - -
0 0 0 0 0 - - - - - 0 0 0 0 0 - - - - - 0 0 0 0 0 - - - - - 0 0 0 0 0 - - - - - 0 0 0 0 0 - - - - -
- - - - - 0 0 0 0 0 - - - - - 0 0 0 0 0 - - - - - 0 0 0 0 0 - - - - - 0 0 0 0 0 - - - - - 0 0 0 0 0
- - - - - 0 0 0 0 0 - - - - - 0 0 0 0 0 - - - - - 0 0 0 0 0 - - - - - 0 0 0 0 0 - - - - - 0 0 0 0 0
- - - - - 0 0 0 0 0 - - - - - 0 0 0 0 0 - - - - - 0 0 0 0 0 - - - - - 0 0 0 0 0 - - - - - 0 0 b 0 0
- - - - - 0 0 0 0 0 - - - - - 0 0 0 0 0 - - - - - 0 0 0 0 0 - - - - - 0 0 0 0 0 - - - - - 0 0 0 0 0
- - - - - 0 0 0 0 0 - - - - - 0 0 0 0 0 - - - - - 0 0 0 0 0 - - - - - 0 0 0 0 0 - - - - - 0 0 0 0 0
0 0 0 0 0 - - - - - 0 0 0 0 0 - - - - - 0 0 0 0 0 - - - - - 0 0 0 0 0 - - - - - 0 0 0 0 0 - - - - -
0 0 0 0 0 - - - - - 0 0 0 0 0 - - - - - 0 0 0 0 0 - - - - - 0 0 0 0 0 - - - - - 0 0 0 0 0 - - - - -
0 0 0 0 0 - - - - - 0 0 0 0 0 - - - - - 0 0 0 0 0 - - - - - 0 0 0 0 0 - - - - - 0 0 0 0 0 - - - - -
0 0 0 0 0 - - - - - 0 0 0 0 0 - - - - - 0 0 0 0 0 - - - - - 0 0 0 0 0 - - - - - 0 0 0 0 0 - - - - -
0 0 0 0 0 - - - - - 0 0 0 0 0 - - - - - 0 0 0 0 0 - - - - - 0 0 0 0 0 - - - - - 0 0 0 0 0 - - - - -
- - - - - 0 0 0 0 0 - - - - - 0 0 0 0 0 - - - - - 0 0 0 0 0 - - - - - 0 0 0 0 0 - - - - - 0 0 0 0 0
- - - - - 0 0 0 0 0 - - - - - 0 0 0 0 0 - - - - - 0 0 0 0 0 - - - - - 0 0 0 0 0 - - - - - 0 0 0 0 0
- - - - - 0 0 0 0 0 - - - - - 0 0 0 0 0 - - - - - 0 0 0 0 0 - - - - - 0 0 0 0 0 - - - - - 0 0 b 0 0
- - - - - 0 0 0 0 0 - - - - - 0 0 0 0 0 - - - - - 0 0 0 0 0 - - - - - 0 0 0 0 0 - - - - - 0 0 0 0 0
- - - - - 0 0 0 0 0 - - - - - 0 0 0 0 0 - - - - - 0 0 0 0 0 - - - - - 0 0 0 0 0 - - - - - 0 0 0 0 0
0 0 0 0 0 - - - - - 0 0 0 0 0 - - - - - 0 0 0 0 0 - - - - - 0 0 0 0 0 - - - - - 0 0 0 0 0 - - - - -
0 0 0 0 0 - - - - - 0 0 0 0 0 - - - - - 0 0 0 0 0 - - - - - 0 0 0 0 0 - - - - - 0 0 0 0 0 - - - - -
0 0 0 0 0 - - - - - 0 0 0 0 0 - - - - - 0 0 0 0 0 - - - - - 0 0 0 0 0 - - - - - 0 0 0 0 0 - - - - -
0 0 0 0 0 - - - - - 0 0 0 0 0 - - - - - 0 0 0 0 0 - - - - - 0 0 0 0 0 - - - - - 0 0 0 0 0 - - - - -
0 0 0 0 0 - - - - - 0 0 0 0 0 - - - - - 0 0 0 0 0 - - - - - 0 0 0 0 0 - - - - - 0 0 0 0 0 - - - - -
- - - - - 0 0 0 0 0 - - - - - 0 0 0 0 0 - - - - - 0 0 0 0 0 - - - - - 0 0 0 0 0 - - - - - 0 0 0 0 0
- - - - - 0 0 0 0 0 - - - - - 0 0 0 0 0 - - - - - 0 0 0 0 0 - - - - - 0 0 0 0 0 - - - - - 0 0 0 0 0
- - - - - 0 0 0 0 0 - - - - - 0 0 0 0 0 - - - - - 0 0 b 0 0 - - - - - 0 0 b 0 0 - - - - - 0 0 c 0 0
- - - - - 0 0 0 0 0 - - - - - 0 0 0 0 0 - - - - - 0 0 0 0 0 - - - - - 0 0 0 0 0 - - - - - 0 0 0 0 0
- - - - - 0 0 0 0 0 - - - - - 0 0 0 0 0 - - - - - 0 0 0 0 0 - - - - - 0 0 0 0 0 - - - - - 0 0 0 0 0
