0 - - - - - - - - - - - - - - - - - - - - - - - - - - - - - - - 0
- 0 0 - - - - - 0 0 0 0 0 0 0 0 0 0 0 0 0 0 0 0 0 - - - - - 0 0 -
- 0 0 - - - - - 0 6 8 0 0 0 0 0 c 0 0 0 0 0 5 7 0 - - - - - 0 0 -
- - - b 0 0 b - 0 8 6 0 0 0 0 0 c 0 0 0 0 0 7 5 0 - b 0 0 b - - -
- - - 0 6 5 0 - 0 0 0 0 0 0 0 0 0 0 0 0 0 0 0 0 0 - 0 7 8 0 - - -
- - - 0 5 6 0 - - - - - - - - - - - - - - - - - - - 0 8 7 0 - - -
- - - b 0 0 b - - - - - - - - - - - - - - - - - - - b 0 0 b - - -
- - - - - - - 0 0 0 0 0 0 0 0 0 0 0 0 0 0 0 0 0 0 0 - - - - - - -
- 0 0 0 0 - - 0 0 0 0 0 0 0 0 0 0 0 0 0 0 0 0 0 0 0 - - 0 0 0 0 -
- 0 0 0 0 - - 0 0 0 0 0 0 0 0 0 0 0 0 0 0 0 0 0 0 0 - - 0 0 0 0 -
- 0 0 0 0 - - 0 0 0 0 0 0 0 0 0 0 0 0 0 0 0 0 0 0 0 - - 0 0 0 0 -
- 0 0 0 0 - - 0 0 0 0 0 0 0 0 0 0 0 0 0 0 0 0 0 0 0 - - 0 0 0 0 -
- 0 0 0 0 - - 0 0 0 0 0 0 0 0 0 0 0 0 0 0 0 0 0 0 0 - - 0 0 0 0 -
- 0 0 0 0 - - 0 0 0 0 0 0 0 0 0 0 0 0 0 0 0 0 0 0 0 - - 0 0 0 0 -
- 0 0 0 0 - - 0 0 0 0 0 0 0 0 0 0 0 0 0 0 0 0 0 0 0 - - 0 0 0 0 -
- 0 0 0 0 - - 0 0 0 0 0 0 0 0 0 i 0 0 0 0 0 0 0 0 0 - - 0 0 0 0 -       8
- 0 0 0 0 - - 0 0 0 0 0 0 0 0 i - i 0 0 0 0 0 0 0 0 - - 0 0 0 0 -       6
- 0 0 0 0 - - 0 0 0 0 0 0 0 0 0 i 0 0 0 0 0 0 0 0 0 - - 0 0 0 0 -       1 2
- 0 0 0 0 - - 0 0 0 0 0 0 0 0 0 0 0 0 0 0 0 0 0 0 0 - - 0 0 0 0 -       33 33
- 0 0 0 0 - - 0 0 0 0 0 0 0 0 0 0 0 0 0 0 0 0 0 0 0 - - 0 0 0 0 -
- 0 0 0 0 - - 0 0 0 0 0 0 0 0 0 0 0 0 0 0 0 0 0 0 0 - - 0 0 0 0 -
- 0 0 0 0 - - 0 0 0 0 0 0 0 0 0 0 0 0 0 0 0 0 0 0 0 - - 0 0 0 0 -
- 0 0 0 0 - - 0 0 0 0 0 0 0 0 0 0 0 0 0 0 0 0 0 0 0 - - 0 0 0 0 -
- 0 0 0 0 - - 0 0 0 0 0 0 0 0 0 0 0 0 0 0 0 0 0 0 0 - - 0 0 0 0 -
- 0 0 0 0 - - 0 0 0 0 0 0 0 0 0 0 0 0 0 0 0 0 0 0 0 - - 0 0 0 0 -
- - - - - - - 0 0 0 0 0 0 0 0 0 0 0 0 0 0 0 0 0 0 0 - - - - - - -
- - - b 0 0 b - - - - - - - - - - - - - - - - - - - b 0 0 b - - -
- - - 0 3 4 0 - - - - - - - - - - - - - - - - - - - 0 2 1 0 - - -
- - - 0 4 3 0 - 0 0 0 0 0 0 0 0 0 0 0 0 0 0 0 0 0 - 0 1 2 0 - - -
- - - b 0 0 b - 0 4 2 0 0 0 0 0 c 0 0 0 0 0 3 1 0 - b 0 0 b - - -
- 0 0 - - - - - 0 2 4 0 0 0 0 0 c 0 0 0 0 0 1 3 0 - - - - - 0 0 -
- 0 0 - - - - - 0 0 0 0 0 0 0 0 0 0 0 0 0 0 0 0 0 - - - - - 0 0 -
0 - - - - - - - - - - - - - - - - - - - - - - - - - - - - - - - 0
0 0 0 <-> 0 32 4
0 0 6 <-> 32 0 2
0 32 6 <-> 32 32 2
32 32 4 <-> 32 0 0
1 24 4 <-> 8 28 6
2 24 4 <-> 8 29 6
3 24 4 <-> 8 30 6
4 24 4 <-> 8 31 6
28 24 4 <-> 24 28 2
29 24 4 <-> 24 29 2
30 24 4 <-> 24 30 2
31 24 4 <-> 24 31 2
1 8 0 <-> 8 1 2
2 8 0 <-> 8 2 2
3 8 0 <-> 8 3 2
4 8 0 <-> 8 4 2
28 8 0 <-> 24 1 6
29 8 0 <-> 24 2 6
30 8 0 <-> 24 3 6
31 8 0 <-> 24 4 6
6 6 4 <-> 15 16 2
6 26 0 <-> 16 15 4
26 26 0 <-> 17 16 6
26 6 4 <-> 16 17 0
